Claud	Faz jgizsukpru
Michale	Bonetti lxpduzlelr
Telma	Falk adztvbefkv
Rebbeca	Campana xvbeflrdsa
Khalilah	Newberg bhmyznebru
Reggie	Diep geyvzirgiz
Gussie	Tardiff qhnjwbdopm
Malka	Brimmer sohhlvkado
Thelma	Mcgraw qltetzigxz
Brenda	Herrell alngjycjwi
Ta	Alers ecnildpmna
Rosette	Foti pooajjrzcy
Hiram	Daughtry mrlrtbtbnk
Kirk	Rhynes jmghodbluj
Marita	Koprowski kerjqxouuf
Nelle	Hanlin hvwlgcejfx
Griselda	Basch pzgfbcorfw
Anton	Kile debdeyriag
Darrel	Puma irhghqkaip
Haywood	Debartolo dlhkucyewc
Angela	Daughdrill fevmveolda
Elaine	Fruchter vomvjjllve
Fredrick	Tomes fmclwgjlew
Nolan	Funes hwmeddcngg
Delana	Speaker itwazttuzc
Hilario	Roache zzgwvueudj
Rosann	Cockburn vgackrzkdj
Soo	Armond jbzkfdmptg
Marvis	Wrench mugevuqgzp
Coreen	Lal ddoleaflaw
Misha	Lastrapes rvzmuvaugb
Drew	Deforge evwfnwsdeh
Larisa	Rostad cmuaxeiztq
Wilson	Stabler rvesbrjuzk
Leota	Largent rxcrtaoytc
Aliza	Creech npvunopaif
Leanora	Fazekas gtijyjsyps
Yuko	Trevathan ufnyojdkot
Cher	Ivy kkgvbvuodf
Susanne	Cranford zyueyediko
Lynetta	Krumm xswcpglpxn
Pamela	Baptist lbhcjqxnny
Russel	Finch nsirkbwevk
Jaimie	Hensen gsutusjbra
Jerrie	Gilder jmrevuhoel
Renita	Midgette yqwvtubbff
Francie	Winter dwppjnrvbf
Chieko	Lechler vmuncntjrb
Elenora	Flake qbzqytzdqw
Twila	Tweedy anwxpnezlu
